■0■0■0■0■0■0■0■0■0■0■0■0■0■0■0■0■0■0■0■0■0■0■0■0■0■0■0■0■0■0■0■0■0■0■0■0■0■0■0■0■0■0■0■0■0■0■0■0■0■0■0■0■0■0■0■0■0■0■0■0■0■0■0■0■0■0■0■0■0
■0╔0═0═0═0═0═0═0═0═0═0═0╦0═0═0═0═0═0═0═0═0═0╦0═0═0═0═0═0═0╗0■0■0■0■0■0■0╔0═0═0═0═0═0═0═0╦0═0═0═0¥0═0═0═0═0═0═0═0╦0═0═0═0═0═0═0═0═0═0═0╗0■0
■0║0■0■0■0■0■0■0■0■0■0■0║0■0■0■0■0■0■0■0■0■0║0■0■0■0■0■0■0║0■0■0■0■0■0■0║0^0■0■0■0■0■0■0║0■0■0■0■0■0■0■0■0■0■0■0║0■0■0■0■0■0■0■0■0■0■0║0■0
■0║0■0■0■0■0■0■0■0■0■0■0║0■0■0■0■0■0■0■0■0■0║0■0■0■0■0■0■0║0■0■0■0■0■0■0║0■0■0■0■0■0g0■0║0■0■0■0■0■0■0■0■0■0■0■0║0■0■0■0■0■0■0■0■0■0■0║0■0
■0║0■0■0■0■0■0■0■0■0■0■0¥0■0■0■0■0■0■0■0■0■0¥0■0■0■0■0■0■0¥0■0■0■0■0■0■0║0■0■0■0■0■0g0■0║0■0■0■0■0■0■0■0■0■0■0■0¥0■0■0■0■0■0■0■0■0■0■0¥0■0
■0║0■0■0■0■0■0■0■0■0■0■0║0■0■0■0■0■0■0■0■0■0║0■0■0■0■0■0■0║0■0■0■0■0■0■0║0■0g0■0■0■0■0■0║0■0■0■0■0■0■0■0■0■0■0■0║0■0■0■0■0■0■0■0■0■0■0║0■0
■0╠0¥0═0═0═0═0═0═0═0═0═0╬0═0═0═0═0═0═0═0═0═0╣0■0■0■0■0■0■0║0■0■0■0■0■0■0║0■0■0■0■0■0■0■0║0■0■0■0■0■0■0■0■0■0■0■0╠0═0═0═0═0═0╦0═0═0═0═0╣0■0
■0║0■0■0■0■0■0■0■0■0■0■0║0■0■0■0■0■0■0■0■0■0╚0╦0═0═0═0═0═0╝0■0■0■0■0■0■0╚0¥0═0═0═0═0═0═0╬0═0═0═0═0═0╦0═0═0═0═0═0╣0■0■0■0■0■0║0■0■0■0■0║0■0
■0║0■0■0■0■0■0■0■0■0■0■0║0■0■0■0■0■0■0■0■0■0■0¥0■0■0■0■0■0■0■0■0■0■0■0■0■0■0■0■0■0■0■0■0║0■0■0■0■0■0║0■0■0■0■0■0║0■0■0■0■0■0║0■0■0■0■0║0■0
■0║0■0■0■0■0■0■0■0■0■0■0║0■0■0■0■0■0■0■0■0f0■0║0■0╔0═0═0═0═0═0═0═0═0═0═0═0═0═0═0═0═0╗0■0║0■0■0■0■0■0║0■0■0■0■0■0║0■0■0■0■0■0║0■0■0■0■0║0■0
■0¥0■0■0■0■0■0■0■0■0■0■0║0■0■0■0■0■0■0■0■0■0■0║0■0║0■0■0■0■0■0■0■0■0■0■0■0■0■0■0■0■0║0■0║0■0■0■0■0■0║0■0■0■0■0■0║0■0■0■0■0■0║0■0■0■0■0║0■0
■0╚0═0═0═0═0═0═0═0═0═0═0╩0═0═0═0═0═0═0═0═0═0═0╝0■0║0■0■0■0■0■0■0■0■0■0■0■0■0■0■0■0■0║0■0╚0═0═0═0¥0═0╩0═0═0═0═0¥0╩0¥0═0═0═0═0╩0¥0═0═0═0╝0■0
■0■0■0■0■0■0■0■0■0■0■0■0■0■0■0■0■0■0■0■0■0■0■0■0■0║0■0■0■0■0g0■0■0■0■0■0■0■0■0■0■0■0¥0■0■0■0■0■0■0■0■0■0■0■0■0■0■0■0■0■0■0■0■0■0■0■0■0■0■0
■0╔0═0═0═0═0═0═0═0═0═0╦0═0═0═0═0═0═0═0═0═0═0═0╗0■0║0■0■0■0■0■0■0■0■0■0g0■0■0■0■0■0■0║0■0╔0═0═0═0¥0═0═0═0═0═0═0═0╦0═0═0═0═0═0═0═0═0═0═0╗0■0
■0║0■0■0■0■0■0■0■0■0■0║0■0■0■0■0■0■0■0■0■0■0■0║0■0║0■0■0■0■0■0■0■0■0■0■0■0■0■0■0■0■0║0■0║0■0■0■0■0■0■0■0■0■0■0■0║0■0■0■0■0■0■0■0■0■0■0║0■0
■0║0■0■0■0■0■0■0■0■0■0║0■0■0■0■0■0■0■0■0■0■0■0║0■0║0■0■0■0■0■0■0■0■0■0■0g0■0■0■0■0■0║0■0║0■0■0■0■0■0■0■0■0■0■0■0║0■0■0■0■0■0■0■0■0■0■0¥0■0
■0║0■0■0■0■0■0■0■0■0■0║0■0■0■0■0m0■0■0■0■0■0■0║0■0╚0═0═0═0═0═0═0═0¥0═0═0═0═0═0═0═0═0╝0■0║0■0■0■0■0■0■0■0■0■0■0■0║0■0■0■0■0■0■0■0■0■0■0║0■0
■0¥0■0■0■0■0■0■0■0■0■0║0■0■0■0■0■0■0■0■0■0■0■0║0■0■0■0■0■0■0■0■0■0■0■0■0■0■0■0■0■0■0■0■0¥0■0■0■0■0■0■0■0■0■0■0■0¥0■0■0■0■0■0■0■0■0■0■0║0■0
■0╠0═0═0═0═0═0═0═0═0═0╬0═0═0═0═0═0═0¥0═0═0═0═0╦0═0═0═0═0═0╗0■0■0■0■0■0■0╔0═0═0═0═0═0═0═0╣0■0■0■0■0■0■0■0■0■0■0■0║0■0■0■0■0■0■0■0■0■0■0║0■0
■0║0■0■0■0■0■0■0■0■0■0║0■0■0■0■0■0■0■0■0■0■0■0║0■0■0■0■0■0║0■0■0■0■0■0■0║0■0■0■0■0■0■0■0╠1═1═1═1═1═1═1═1═1═1¥1═1╬1═0═0¥0═0═0═0═0═0═0═0╣0■0
■0║0■0■0■0■0■0■0■0■0■0¥0■0■0■0■0■0■0■0■0■0■0■0¥0■0■0■0■0■0¥0■0■0■0■0■0■0║0■0■0■0■0■0■0■0║1[1]1[1]1■1■1■1■1®1■1■1║1■0■0■0■0■0■0■0■0■0■0¥0■0
■0║0■0■0■0■0■0■0■0■0■0║0■0■0■0■0■0■0■0■0■0■0■0║0■0■0■0■0■0║0■0■0■0■0■0■0║0■0■0■0■0■0■0■0║1[1]1[1]1*1■1■1■1■1■1■1¥1■0■0■0■0■0■0■0■0■0■0║0■0
■0║0■0■0■0■0■0■0■0■0■0║0■0■0■0■0■0■0■0■0■0■0■0║0■0■0■0■0■0║0■0■0■0■0■0■0║0■0■0■0■0■0■0■0║1■1■1■1■1■1■1º1■1■1■1■1║1■0■0■0■0■0■0■0■0■0■0║0■0
■0╚0═0═0═0═0¥0═0═0═0═0╩0═0═0═0¥0═0═0═0═0═0═0═0╩0═0═0¥0═0═0╝0■0■0■0■0■0■0╚0¥0═0═0═0═0═0═0╩1═1═1═1═1═1═1═1¥1═1═1═1╩1¥0═0═0═0═0═0═0═0═0═0╝0■0
■0■0■0■0■0■0■0■0■0■0■0■0■0■0■0■0■0■0■0■0■0■0■0■0■0■0■0■0■0■0■0■0■0■0■0■0■0■0■0■0■0■0■0■0■0■0■0■0■0■0■0■0■0■0■0■0■0■0■0■0■0■0■0■0■0■0■0■0■0
